Nivel 2:
  1   1   1   1   1   1   1   1   1   1 
  1   1   1   1   1   1   1   1   1   1 
  1   1   1   1   1   1   1   1   1   1 
  1   0   0   2   0   0   1  10  10   1 
  1   0   2   0   2   0   1  10  10   1 
  1   7   1   1   1   0   1   1   0   1 
  1   2  10  10   1   2   0   2   0   1 
  1   2  10  10   1   2   0   2   0   1 
  1   0   1   1   1   7   1  10  10   1 
  1   0   1   0   2   7   1  10  10   1 
  1   0   1   8   1   7   1   1   1   1 
  1   0   1   1   1   0   0   0   0   1 
  1   2   2   7   7   0   0   4   0   1 
  1   2   2   1   1   0   0   0   0   1 
  1   1   1   1   1   1   1   1   1   1 

Nivel 3:
  1   1   1   1   1   1   1   1   1   1 
  1   1   1   1   1   1   1   1   1   1 
  1   1   1   1   1   1   1   1   1   1 
  1   0   0   0   1   0   1   0   2   1 
  1   4   0   1   1   0   5   0   8   1 
  1   0   0   7   0   0   1   0   2   1 
  1   1   7   1   5   1   1   1   1   1 
  1   0   0   1   0   0   1   2   2   1 
  1   0   2   1   0   0   5   3   2   1 
  1   1   0   1   0   0   1   2   2   1 
  1   3   0   1   2   0   1   1   1   1 
  1   0   1   1   0   0   1   0   0   1 
  1   2   7   7   0   0   5   3   2   1 
  1   0   1   1   1   3   1   0   0   1 
  1   1   1   1   1   1   1   1   1   1 

Nivel 4:
  1   1   1   1   1   1   1   1   1   1 
  1   1   1   1   1   1   1   1   1   1 
  1   1   1   1   1   1   1   1   1   1 
  1   0   4   0   0   0   0   0   0   1 
  1   1   1   1   1   1   6   1   1   1 
  1   0   0   2   2   0   9   0   0   1 
  1   6   1   1   1   1   1   1   1   1 
  1   9   0   0   0   6   0   2   0   1 
  1   1   1   1   1   1   2   1   1   1 
  1   0   0   0   0   0   0   0   0   1 
  1   0   6   0   0   0   0   0   0   1 
  1   1   0   0   6   1   9   1   0   1 
  1   1   1   9   2   1   8   1   0   1 
  1   1   1   1   2   1   1   1   0   1 
  1   1   1   1   1   1   1   1   1   1 

Nivel 5:
  1   1   1   1   1   1   1   1   1   1 
  1   1   1   1   1   1   1   1   1   1 
  1   1   1   1   1   1   1   1   1   1 
  1   8   1   1   1   1   1   2   2   1 
  1   4   7   0   0   3   1   2   2   1 
  1   7   1   1   6   1   1   1   5   1 
  1   2   1   0   0   0   1   1   9   1 
  1   2   1   0   0   0   0   0   0   1 
  1   9   1   0   0   0   0   0   0   1 
  1   0   0   0   0   0   1   0   0   1 
  1   0   0   0   0   1   1   1   0   1 
  1  10  10  10   0   1   1   1   6   1 
  1  10  10  10   0   7   7   0   0   1 
  1   1   1   1   1   2   2   1   1   1 
  1   1   1   1   1   1   1   1   1   1 

Nivel 6:
  1   1   1   1   1   1   1   1   1   1 
  1   1   1   1   1   1   1   1   1   1 
  1   1   1   1   1   1   1   1   1   1 
  1   0   0   0   0   4   0   0   0   1 
  1   0   6   0   2   2   0   6   3   1 
  1   9   1   0   1   1   0   1   9   1 
  1   0   0   0   0   0   0   0   0   1 
  1   0   0   0   0   0   0   0   0   1 
  1   0   0   1   1   5   1   0   0   1 
  1   0   2   1   8   2   1   0   2   1 
  1   1   5   1   1   1   1   7   1   1 
  1   9   0   2   2   2   0   0   0   1 
  1   0   1   1   1   1   1   1   7   1 
  1   7   0   2   3   2   0   0   0   1 
  1   1   1   1   1   1   1   1   1   1 

Nivel 7:
  1   1   1   1   1   1   1   1   1   1 
  1   1   1   1   1   1   1   1   1   1 
  1   1   1   1   1   1   1   1   1   1 
  1   1   6   0   6   0   1   1   0   1 
  1   6   4   6   0   6   0   1   0   1 
  1   0   6   1   2   1   6   1   2   1 
  1   6   0   6   0   6   1   1   6   1 
  1   1   6   0   9   0   1   3   2   1 
  1   0   2   0   1   6   1   0   6   1 
  1   6   1   1   6   0   1   0   2   1 
  1   9   6   0   0   2   0   9   1   1 
  1   0   0   1   1   5   1   1   6   1 
  1   2   0   1   0   2   0   1   0   1 
  1   0   1   1   0   8   0   1   6   1 
  1   1   1   1   1   1   1   1   1   1 

Nivel 8:
  1   1   1   1   1   1   1   1   1   1 
  1   1   1   1   1   1   1   1   1   1 
  1   1   2   0   2   0   2   0   1   1 
  1   1   0   1   1   1   1   2   1   1 
  1   1   2   1   0   8   1   0   1   1 
  1   1   0   2   0   2   1   0   1   1 
  1   1   1   1   1   1   1   5   1   1 
  1   1  12   0   6   4   0   2   1   1 
  1   1   1   1   1   1   1  11   1   1 
  1   1   9   6   2   7  11   0   1   1 
  1   1   3   1   7   7   1   0   1   1 
  1   1   6   1   7   7   1   7   1   1 
  1   1   9   6   0   2  12   2   1   1 
  1   1   1   1   1   1   1   1   1   1 
  1   1   1   1   1   1   1   1   1   1 

Nivel 9:
  1   1   1   1   1   1   1   1   1   1 
  1   1   1   1   1   1   1   1   1   1 
  1   1   1   1   1   1   1   1   1   1 
  1   0   0   0   0   4   0   0   0   1 
  1   0   6   2   2   0   0   0   0   1 
  1  12   1   1  11   1   1   1   1   1 
  1   2   0   0   6   2   2   0   1   1 
  1   1   0   0   0   0   0   0  12   1 
  1   1  11   1   1   1   1   1   1   1 
  1   0   0   1   0   0   2   0   0   1 
  1   0   0   0   0   0   0   2   0   1 
  1   0   1   0   1   0   1  11   1   1 
  1   0   6   0   1  12   1   2   0   1 
  1   2   2   2   1   2   1   0   8   1 
  1   1   1   1   1   1   1   1   1   1 

Nivel 10:
  1   1   1   1   1   1   1   1   1   1 
  1   1   1   1   1   1   1   1   1   1 
  1   1   1   1   1   1   1   1   1   1 
  1   0   0   7   0   0   7   0   0   1 
  1   2   1   1   0   0   1   1   2   1 
  1   2   2   1   8   0   1   2   2   1 
  1   0   2   1   1   4   1   2   0   1 
  1   1   0   1   0   0   1   0   1   1 
  1   2   9   0   7   7   0   9   2   1 
  1   1   7   1   20  20  1   7   1   1 
  1   0   0   0   0   0   0   0   0   1 
  1   0   6   0   0   0   0   6   0   1 
  1   0   1   0   6   6   0   1   0   1 
  1   0   0   0   0   0   0   0   0   1 
  1   1   1   1   1   1   1   1   1   1 

Nivel 11:
  1   1   1   1   1   1   1   1   1   1 
  1   1   1   1   1   1   1   1   1   1 
  1   1   1   1   1   1   1   1   1   1 
  1   3   0   0   1   1   1  12   0   1 
  1   0   4   0   8   2  11   0   0   1 
  1   7   1   1   1   1   1   9   1   1 
  1   0   0   1   2   2   1   2   0   1 
  1   0   2   0   0   0   1   2   0   1 
  1   7   1   1   1   0   0   0   1   1 
  1   0   7   0   1   9   6   0   3   1 
  1   6   1   0   1   0   0   0   1   1 
  1   0   2   2   0   6   0   0   1   1 
  1   9   1   1   1   6   1   7   1   1 
  1   0   7   2   5   0   5   2   2   1 
  1   1   1   1   1   1   1   1   1   1 

Nivel 12:
  1   1   1   1   1   1   1   1   1   1 
  1   1   1   1   1   1   1   1   1   1 
  1   1   1   1   1   1   1   1   1   1 
  1   0   2   4   0   7   1   2   1   1 
  1   1   1   1   1   0   7   0   7   1 
  1   1   0   5   0   7   1   1   6   1 
  1   2   0   1   0   0   0   7   2   1 
  1   1   0   1   1   1   1   1   0   1 
  1   1  11   1  10   1  10   1   0   1 
  1   2   2   0   0   1   0   0   0   1 
  1   7   1   1   6   1   0   1   2   1 
  1   7   1   0   0   1   0   6   9   1 
  1   3   2   2   0   12  0   0   8   1 
  1   1   1   1   1   1   1   1   1   1 
  1   1   1   1   1   1   1   1   1   1 

Nivel 13:
  1   1   1   1   1   1   1   1   1   1 
  1   1   1   1   1   1   1   1   1   1 
  1   1   1   1   1   1   1   1   1   1 
  1   2   2   0   7   0   2   0   3   1 
  1   2   1   7   1   1   5   1   1   1 
  1   1   1   0   0   2   0   0   0   1 
  1   2   1   0   1   6   1   1   7   1 
  1   0   7   3  11  12   0   0   2   1 
  1   0   1   0   1   1   0   1   1   1 
  1   2   1   7   1   0   0   1   7   1 
  1   0   1   0   1   2   0   7   8   1 
  1   5   1   7   1   1   7   1   1   1 
  1   0   0   2   4   0   0   2   0   1 
  1   1   1   1   1   1   1   1   1   1 
  1   1   1   1   1   1   1   1   1   1 

Nivel 14:
  1   1   1   1   1   1   1   1   1   1 
  1   1   1   1   1   1   1   1   1   1 
  1   1   1   1   1   1   1   1   1   1 
  1   0   0   2   0   0   1   2   2   1 
  1   1  11   1   8   1   1   2   2   1 
  1   0   0   0   1   0   1  11   1   1 
  1   2   0   0   2   1   0   0   0   1 
  1   0   1  11   1   0   1   9  12   1 
  1   1   0   6  12   1   2   0   0   1 
  1   0   0   0   1   2   0   0   0   1 
  1   1   5   1   0   1   1   6   1   1 
  1  12   0   0  12   0  11   0   0   1 
  1   1   0   0   6   0   1   1   3   1 
  1   1   1   1   4   1   1   1   1   1 
  1   1   1   1   1   1   1   1   1   1 

Nivel 15:
  1   1   1   1   1   1   1   1   1   1 
  1   1   1   1   1   1   1   1   1   1 
  1   1   1   1   1   1   1   1   1   1 
  1   8   0   1   0   7   0   2   0   1 
  1   1   5   1   0   1   0   6   0   1 
  1   0   0   1   0   1   0   0   0   1 
  1   4   0   2   0   1   2  12   0   1 
  1   7   1   1   0   1   0   6   0   1 
  1   2   1   1   0   7   0   0   0   1 
  1   0   0   1   7   1   1   1   6   1 
  1   1   7   1   2   6   9   0   0   1 
  1   0   0   1   1   1   6   1   1   1 
  1   3   0  11   0   2   0   2   0   1 
  1   1   1   1   1   1   1   1   1   1 
  1   1   1   1   1   1   1   1   1   1 

Nivel 16:
  1   1   1   1   1   1   1   1   1   1 
  1   1   1   1   1   1   1   1   1   1 
  1   1   1   1   1   1   1   1   1   1 
  1  10  10  10  10  10  10  10  10   1 
  1  10  10   1  10  10   1  10  10   1 
  1  10  10  10  10  10  10  10  10   1 
  1   4   0   0   1   0   0   1   2   1 
  1   0   1   0   0   0   0   6   0   1 
  1   0   1   6   1   1   6   1   0   1 
  1   0   1   0   0   2   0   1   0   1 
  1   2   0   0   0   1   0   1   0   1 
  1   0   1   1   0   0   0   2   0   1 
  1   0   1   2   0   1   1   1   1   1 
  1   0   0   0   0   9   9   9   8   1 
  1   1   1   1   1   1   1   1   1   1 

Nivel 17:
  1   1   1   1   1   1   1   1   1   1 
  1   1   1   1   1   1   1   1   1   1 
  1   1   1   1   1   1   1   1   1   1 
  1   0   0   2   0   7   0   1   3   1 
  1   2   1   1   1   1   0   1  11   1 
  1   0  11   3  12  11   0  12   0   1 
  1   4   1   1   2   1   1   1   2   1 
  1   0   7   0   6   0   0   0   0   1 
  1   0   7   0   6   0   1   1   1   1 
  1   0   1   1   0   1   1   1  12   1 
  1   1   1   0   0   6   0   0   0   1 
  1   2   1   7   7   1   1   0   2   1 
  1   2   5   0   0   2   1   5   1   1 
  1   1   1   1   1   1   1   0   8   1 
  1   1   1   1   1   1   1   1   1   1 

Nivel 18:
  1   1   1   1   1   1   1   1   1   1 
  1   1   1   1   1   1   1   1   1   1 
  1   1   1   1   1   1   1   1   1   1 
  1   0   2   0   2   0   2   0   2   1 
  1   2   1   1   1   1   1   1  11   1 
  1   0   1   0   0   2   0   0   0   1 
  1   2   1  12   1   1   0   1   7   1 
  1   0   1   0  11   8   2   6   0   1 
  1   2   1   4   1   1   0   1   2   1 
  1   0   1   0   7   0   0   1   0   1 
  1   2   1   6   1   1  12   1   2   1 
  1   0   1   0   0   7   0   1   0   1 
  1   2   6  12   0   1   2  11   0   1 
  1   1   1   1   1   1   1   1   1   1 
  1   1   1   1   1   1   1   1   1   1 

Nivel 19:
  1   1   1   1   1   1   1   1   1   1 
  1   1   1   1   1   1   1   1   1   1 
  1   1   1   1   1   1   1   1   1   1 
  1   8   1   1   3   1   0   2   0   1 
  1   2   1   0   0   1   0   1   7   1 
  1  11  12   0   0  11   0   0   0   1 
  1   0   1   1   4   1   1   0   0   1 
  1   0   7   0   2   1   1   6   2   1 
  1   0   1   0   0   0   0   0   1   1 
  1   0   1   1   6   1   1   0   0   1 
  1   2   0   2   0   1   0   0  12   1 
  1   0   1   1   1   1   7   1   1   1 
  1   0   5   0   0   0   2   0   1   1 
  1   1   1   1   1   1   1   1   1   1 
  1   1   1   1   1   1   1   1   1   1 

Nivel 20:
  1   1   1   1   1   1   1   1   1   1 
  1   1   1   1   1   1   1   1   1   1 
  1   9   0   0   6   0   0   6   0   1 
  1   1   6   1   1   0   0   0   0   1 
  1   1   0   0   0   6   0   4   0   1 
  1   0   0   6   0   9   9   1   1   1 
  1   6   0   0   6   1   6   6   1   1 
  1   1   1   1   9   1   0   6   0   1 
  1   9   9   9   6   6   9   0   0   1 
  1  13   1   1   9   6   1   1   0   1 
  1   1   1   0   0   6   1   0   0   1 
  1   0   0   0   0   9   6   6   6   1 
  1   0   9   6   6   1   0   0   0   1 
  1   6   0   0   0   1   0   6   0   1 
  1   1   1   1   1   1   1   1   1   1

